#######
#!  #*#
#x@+ -#
#x    #
#x¡   #
#######