#######
#!  #*#
#x + -#
#x   @#
#x¡   #
#######