#######
#!* ###
#x + -#
#x   @#
#x¡   #
#######