#######
#!* ###
#x + -#
#x @  #
#x¡   #
#######