#######
#!*####
#x ####
#x@####
#x#####
#######