#######
#!* ###
#x + -#
#x@   #
#x¡   #
#######