#########
###!###*#
## x+ --#
#  x-  -#
# +xx++ #
#- xx +@#
#¡-x!   #
#########
