#######
#x* ###
#x + -#
#x   @#
#!¡   #
#######